10x10
1111100000
1110011110
0000110000
0000010000
0011110000
0000010000
0000111000
0000101100
0001100000
0001000000