10x10
1111100000
0010111000
0000001110
0000001100
0000011000
0001111000
1111000000
0001111111
1111001111
1000000000