10x10
1000000000
1111111111
0000110001
0000010001
0011110001
0000011111
0000111000
0000101100
0001100000
0000100000