10x10
1000000000
1111111001
0111111101
0110001000
0011111001
0001011111
0011111001
0011101100
0001100100
0000000100